151x102
*******************************************************************************************************************************************************
* *              *              *  *  *     *        *  *        *           *  *     *     *  *  *     *              *              *     *  *     *
*  *******  ****  ****  *******  *  *  ****  *  *  *  *  *  ****  ****  *******  *  ****  ****  *  *  *  *******  *******  *  ****  ****  *  *  ****  *
*     *     *        *     *              *     *  *        *     *  *                 *     *        *  *              *  *     *        *  *        *
*  *******  ****  *  *  *******  ****  *  **********  ****  ****  *  *  *  **********  *  *  ****  *******  *  *  ****  **********  *******  *  ****  *
*     *        *  *  *  *           *  *        *  *  *     *  *        *     *     *     *     *        *  *  *  *  *  *  *           *     *  *  *  *
*  **********  ****  ****  *******  ****  *******  **********  *  **********  *  *******  ****  *  *  *******  ****  *  *  *  ****  *  *******  *  *  *
*              *        *  *     *  *  *     *     *           *  *  *           *        *        *     *  *  *        *  *     *  *  *  *        *  *
*******  *  ****  *  *  *  *  ****  *  *******  *  ****  ****  *  *  *******  *  *  **********  *  ****  *  **********  *  *  *******  *  ****  *******
*     *  *     *  *  *  *  *     *     *  *     *  *  *  *        *  *        *  *  *  *  *     *  *     *  *           *     *     *                 *
*  ****  *************  *  ****  *******  *  ****  *  *************  ****  *  *  ****  *  *******  ****  *  ****  ****  *  ****  *******  *  *******  *
1     *  *                    *        *  *     *  *        *        *  *  *  *  *     *     *     *  *  *           *     *           *  *     *     *
*  ****  *  *  *  *  ****  ****  *  *  *  *  *  *  ****  *  *  ****  *  ****  ****  ****  *  *******  *  *  *  *******  *******  *  *******  *******  *
*     *  *  *  *  *  *     *  *  *  *  *  *  *  *     *  *        *     *              *  *     *        *  *        *  *  *  *  *        *        *  *
*  *******************  *  *  ****  ****  ****  *******************  *******  ****************  *  ****  ****  *  ****  *  *  ****  *  ****  *  *  *  *
*  *     *     *        *        *  *  *           *  *     *        *     *     *           *        *        *  *  *     *  *  *  *     *  *  *  *  *
*  *  *  ****  ****  ****  *******  *  ****  *******  *  **********  *  *  *******  *  *******  *  *******  *******  *  ****  *  *  *  *************  *
*     *     *  *        *        *     *     *     *  *     *        *  *           *  *        *  *     *        *  *  *     *  *  *     *  *  *     *
****  *******  *  *  *******  *  ****  *  *  ****  *  ****  ****  ****  ****  ****  *  *******  ****  *  *  *  ****  *  ****  *  ****  ****  *  *******
*     *  *        *  *  *     *  *  *  *  *     *     *  *  *              *     *  *     *     *     *  *  *  *                    *        *        *
****  *  ****  ****  *  **********  *  ****  ****  *  *  *  *******  *******************  ****  *  ****  *  *************  *******  *  *******  *******
*        *     *  *     *  *  *        *  *        *        *           *  *     *     *     *        *  *  *           *  *        *                 *
****  ****  *  *  *  *  *  *  *  *******  *******  ****  ****  ****  ****  *  *******  **********  ****  *  ****  *************  *  *  *  ****  *  *  *
*  *  *  *  *  *     *  *        *     *     *        *  *  *     *  *  *     *     *  *     *        *  *     *           *  *  *     *     *  *  *  *
*  *  *  ****  *  ****  *  ****  ****  *  *  *******  ****  *  *******  *  ****  ****  ****  ****  ****  ****  **********  *  *  ****  *******  ****  *
*  *     *     *     *     *  *        *  *        *     *     *  *        *        *  *           *     *  *     *  *     *  *  *        *        *  *
*  *  *  *  ****************  ****  **********  *  ****  ****  *  *  *  ****  *  *  *  **********  *******  *  ****  *  *  *  ****  *  *************  *
*  *  *     *  *     *  *     *     *           *     *           *  *  *     *  *  *     *           *  *     *  *     *        *  *  *  *     *     *
*  *******  *  *  ****  *  ****  *  **********  *******  *  ****  *  **********  *  ****  ****  *******  *  ****  ****  ****  *  ****  *  ****  *  ****
*                          *  *  *  *  *                 *     *  *  *           *     *        *  *  *        *     *  *  *  *     *  *     *     *  *
*  *******  **********  ****  ****  *  ****  *  **********  *******  **********  *******  *  *  *  *  *******  ****  *  *  *  *************  *  *  *  *
*        *     *              *        *     *  *                 *           *  *  *     *  *        *        *        *  *        *     *  *  *  *  *
*  *************  *******  ****  *  *  ****  *************  *  *******  *******  *  ****  ****  *  ****  ****************  ****  *  ****  *  *******  *
*     *                 *  *  *  *  *  *  *  *     *        *     *     *                 *     *  *     *     *     *        *  *              *     *
*  *******  *************  *  **********  *******  *  ****  ****  *  ****  *  *******  *  *******  *******  ****  **********  *******  ****  *******  *
*        *     *        *     *  *  *  *  *  *  *  *     *  *              *  *  *  *  *        *     *  *  *  *     *                    *  *     *  *
*  *******  ****  ****  *  *  *  *  *  *  *  *  *  *  *  *  *  ****************  *  *******************  *  *  *  **********  *******  *  ****  ****  *
*  *        *        *     *                          *  *  *           *  *        *  *           *     *        *              *  *  *  *  *        *
*  ****  ****  ****  *************  *******  ****  *  ****  *************  *******  *  *  *************  ****  *******  *  ****  *  *  *  *  *  *******
*     *     *  *              *        *  *  *     *  *                          *  *  *        *                 *     *  *     *     *              *
**********  *  ****  *  ****************  *  *******  *  *  ****  *  *******  ****  *  *  *************  ****************  *  ****  *  ****  ****  *  *
*  *  *  *  *     *  *  *        *           *  *     *  *     *  *     *  *                 *  *     *           *  *  *  *  *     *     *     *  *  *
*  *  *  **********  *******  ****  *******  *  ****  *  ****************  ****  ****  *******  *  ****  *  *******  *  ****  *******  ****************
*  *     *  *           *     *           *  *  *     *  *        *              *     *  *     *  *     *     *  *        *        *        *     *  *
*  ****  *  *******  *******  *  *  ****  ****  *  ****  *  *  *************  **********  ****  *  *  *  ****  *  ****  *  *******  **********  ****  *
*           *           *     *  *     *  *        *     *  *     *  *     *                 *        *  *  *  *  *     *              *  *  *     *  *
****  ****  *  ****  ****  **********  *******  *  *  ****  *  ****  *  ****  ****  ****************  ****  *  *  *  ****  *  **********  *  *  ****  *
*  *  *     *  *        *  *           *     *  *  *     *  *     *              *              *  *        *           *  *  *        *              2
*  *******  *************  ****************  ****  *************  *  ****  *******  *************  *******  *******  *  ****  *  ****  *  ****  *  ****
*                    *              *              *        *  *     *     *     *     *        *  *  *  *     *     *     *  *  *        *  *  *     *
*******  *******  *  *  *******  **********  ****  *  *******  **********  *  *  ****  *  ****  *  *  *  *  *  *******  **********  *******  *******  *
*  *  *  *        *     *     *        *  *     *     *  *  *        *        *  *     *  *        *        *  *        *  *              *        *  *
*  *  *  *************  *  *  *******  *  *******  *  *  *  *******  ****  *******  *  *******  *******  **********  *  *  **********  *  *  ****  *  *
*     *     *              *  *                 *  *        *        *  *     *  *  *        *  *           *  *     *     *        *  *  *  *     *  *
****  *******  ****  ****  *  *******  **********  *******  *  ****  *  *  *  *  *  ****  *  *  *  *  *  ****  *******  *  *  *******  *******  ****  *
*        *        *  *     *  *     *        *        *           *  *     *     *  *  *  *        *  *  *  *  *  *  *  *  *        *        *     *  *
*  ****  *  *  *  *  *  **********  ****  *  ****  ****  *  *  **********  *  *******  *******  ****  *  *  *  *  *  *  *  *  *  **********  *  ****  *
*     *  *  *  *  *  *     *              *  *  *     *  *  *  *        *  *        *  *     *     *  *     *           *  *  *        *     *        *
*  *  *******  ****  ****  ****  *  ****  ****  *  *******  *  *  ****  ****  *******  *  ****  *******  ****************************  ****  *  *  ****
*  *  *        *        *     *  *     *           *        *  *  *  *  *  *  *  *  *  *           *     *     *              *  *  *     *  *  *     *
****  *  ****  ****  ****************  *  *******  *  *************  *  *  *  *  *  *  ****  **********  *  *  ****  *******  *  *  ****  ****  *******
*     *     *     *  *     *  *  *     *  *     *  *  *  *     *           *     *        *     *     *     *  *        *              *           *  *
****  *  *******  ****  *  *  *  **********  ****  ****  *  ****  *  *  *  *  *******  **********  *  ****  *************  *  ****  *  *  *  *******  *
*     *  *        *  *  *  *              *  *  *  *        *  *  *  *  *        *              *  *  *  *  *  *        *  *  *  *  *  *  *     *     *
****  ****  *  ****  *  *  *******  *  ****  *  *  ****  *  *  *  *  *************  *  *  **********  *  ****  ****  *  *  ****  **********  ****  *  *
*           *  *  *  *  *  *  *  *  *        *        *  *     *  *                 *  *  *        *           *     *  *     *           *     *  *  *
****  *******  *  *  *  *  *  *  *******  *******  *  ****  *  *******  ****************  ****  ****  *  *************  *  ****  *  **********  *  ****
*  *  *  *        *     *  *        *     *     *  *  *  *  *  *     *        *  *  *  *  *        *  *     *        *           *     *  *  *        *
*  *  *  ****  *******  *  *  *******  *  ****  *  ****  ****  *  ****  *******  *  *  *  *  ****  *  **********  ****  *  *  *******  *  *  *  ****  *
*        *  *  *  *     *        *     *  *     *     *  *     *  *  *  *     *              *              *  *        *  *     *     *  *     *     *
**********  ****  *******  ****  ****  *  *  *******  *  *  ****  *  ****  ****  *  ****  *******  *******  *  ****  *  ****  *  *******  *******  ****
*        *  *     *     *     *  *  *  *  *        *     *           *  *     *  *     *  *  *  *        *        *  *     *  *  *     *     *     *  *
*  *******  *  *******  ****  ****  *  ****  *  *  *  *  ****  *  ****  *  *******  *******  *  ****  *************  ****  ****  *  *******  *  ****  *
*  *  *           *     *  *  *  *           *  *     *     *  *  *        *           *  *     *        *           *        *              *        *
*  *  ****  ****  *  ****  *  *  ****  *******  ****  *  *  *  ****  **********  *******  ****  *  *******  *******  **********  ****  *******  *  ****
*           *  *              *        *        *     *  *  *           *  *        *     *  *              *  *     *     *        *        *  *  *  *
*  *******  *  *  ****  **********  *******  ****  *************  *******  *  *  *  ****  *  ****  *******  *  *******  ****  ****************  ****  *
*        *     *  *              *  *        *     *     *     *     *        *  *  *  *     *           *  *              *              *           *
*  **********  ****  **********  *******  ****  ****  *  *  ****  ****  **********  *  ****  ****  ****  *  *  ****  *  *  *******  *  *************  *
*     *  *     *     *        *  *           *  *     *     *     *  *  *     *  *     *     *  *     *  *        *  *  *     *     *  *  *           *
*  ****  *******  ****  ****  *******  *  *  *  *  ****  *  ****  *  *******  *  *  *  *  ****  ****  *  *  *  ****************  *  ****  *  *******  *
*  *        *  *  *        *     *     *  *  *        *  *              *     *  *  *           *     *  *  *  *     *           *                 *  *
****  *******  *  *  *  *  *  *  *  *************  *  *************  ****  ****  *  *******  *******  ****  ****  *  ****************  *  **********  *
*                    *  *  *  *  *     *  *  *     *  *     *  *              *           *        *     *  *     *           *        *           *  *
*  *  ****  *  *******************  ****  *  *******  ****  *  ****  *******  *******  *  ****  ****  *******  *  *******  *************  ****  *******
*  *  *     *     *  *           *              *              *     *              *  *  *     *           *  *        *     *           *     *  *  *
*******  *  *  ****  ****  *  *  *  *  *  **********  ****  *  *  *******  *  ****  *  ****  **********  *******  *  *  *  **********  **********  *  *
*     *  *  *     *     *  *  *     *  *  *  *  *  *     *  *  *  *        *  *     *     *  *     *        *     *  *  *     *  *     *     *  *  *  *
*  *  *  ****  *  *  *  ****  *  *******  *  *  *  *  *  *  *  ****  *******  ****************  *  *  *  ****  **********  ****  ****  *  ****  *  *  *
*  *     *  *  *     *     *  *        *  *     *     *  *  *  *     *        *     *     *  *  *     *        *        *     *           *           *
*  *******  **********  ****  *  ****  *******  *******  **********  ****  ****  *  ****  *  *******  ****  *  ****  ****  *  *************  *  ****  *
*        *           *  *     *     *     *  *     *     *  *  *     *        *  *     *  *  *     *  *  *  *  *  *        *  *  *        *  *  *     *
*  *  *  *  **********  ****  *  ****  ****  *  **********  *  *  ****  *  *  ****  ****  *  *  *******  *  ****  **********  *  *******  **********  *
*  *  *              *        *  *        *        *           *  *     *  *        *        *  *        *  *        *  *                 *           *
*******  *******  ****  *******  ****  **********  *  *  *  *************  ****  *******  ****  *******  *  *  ****  *  *******  *************  ****  *
*        *  *     *        *     *           *        *  *     *     *  *  *  *              *                 *        *           *  *  *        *  *
**********  *******  *******  *************  *  *  *******  ****  ****  *  *  *  *  ****  ****  ****  *  *******  *  *******  *******  *  ****  ****  *
*     *        *  *  *  *  *  *           *     *        *           *  *     *  *     *     *  *  *  *  *     *  *  *  *  *                 *     *  *
*  *******  *  *  *  *  *  ****  *******  *  *  *  *  *******  *  ****  *  **********  ****  *  *  ****  *  **********  *  *  *******  ****  *  ****  *
*           *                 *     *        *  *  *     *     *        *     *           *  *        *     *                 *           *     *     *
*******************************************************************************************************************************************************