29x22
*1 ****************************
*  *  *  *  *           *     *
*  *  *  *  *******  *  *  *  *
*     *     *        *     *  *
****  *  *  *  *************  *
*     *  *        *  *  *     *
****  *  *  *******  *  *  ****
*        *  *  *     *        *
*  *  ****  *  ****  *  ****  *
*  *  *  *  *  *  *  *     *  *
****  *  ****  *  *  *  *  ****
*  *     *     *  *  *  *     *
*  *  ****  ****  *  *  *******
*  *        *     *        *  *
*  *******  ****  *******  *  *
*              *        *     *
*  **********  *  ****  ****  *
*  *  *              *  *     *
*  *  *******  *  *  ****  *  *
*           *  *  *     *  *  *
**************************** 2*